  Greetings & Farewells                                                                                    
                                                                                                           
  1. Tena koe → Tēnā koe (hello to one person)                                                             
  2. Tena korua → Tēnā kōrua (hello to two people)                                                         
  3. Tena koutou → Tēnā koutou (hello to three or more)                                                    
  4. Haere ra → Haere rā (goodbye to person leaving)                                                       
  5. E noho ra → E noho rā (goodbye to person staying)                                                     
  6. Ma te wa → Mā te wā (in time/eventually)                                                              
  7. Ka kite ano → Ka kite anō (see you again)                                                             
  8. Kei te pehea koe → Kei te pēhea koe (How are you?)                                                    
  9. Hei konei ra → Hei konei rā (goodbye - informal)                                                      
                                                                                                           
  Culture & Concepts                                                                                       
                                                                                                           
  10. Ta moko → Tā moko (traditional tattoo)                                                               
  11. Pakeha → Pākehā (European/non-Māori)                                                                 
  12. pa → pā (fortified village)                                                                          
  13. Kare → Kāre (no/not)                                                                                 
  14. noku te whiwhi → nōku te whiwhi (my gain/lucky me)                                                   
  15. Turangawaewae → Tūrangawaewae (place of standing/home)                                               
  16. Kainga → Kāinga (home/village)                                                                       
                                                                                                           
  People & Family                                                                                          
                                                                                                           
  17. kaumatua → kaumātua (elder)                                                                          
  18. hapu → hapū (sub-tribe/pregnant)                                                                     
  19. tungane → tungāne (brother of a female)                                                              
  20. tuakana → tuākana (older sibling)                                                                    
  21. tuahine → tuāhine (sister/female cousin of male)                                                     
  22. whanau → whānau (family)                                                                             
  23. potiki → pōtiki (youngest child)                                                                     
  24. matamua → mātāmua (firstborn)                                                                        
  25. iramutu → irāmutu (nephew/niece)                                                                     
  26. tamahine → tamāhine (daughter/girl)                                                                  
  27. matua → mātua (parents - plural)                                                                     
  28. Tipuna → Tīpuna (ancestors - plural, eastern dialect)                                                
                                                                                                           
  Days of the Week                                                                                         
                                                                                                           
  29. Ratapu → Rātapu (Sunday)                                                                             
  30. Rahina → Rāhina (Monday)                                                                             
  31. Ratu → Rātū (Tuesday)                                                                                
  32. Raapa → Rāapa (Wednesday)                                                                            
  33. Rapare → Rāpare (Thursday)                                                                           
  34. Ramere → Rāmere (Friday)                                                                             
  35. Rahoroi → Rāhoroi (Saturday)                                                                         
                                                                                                           
  Places (Cities)                                                                                          
                                                                                                           
  36. Akarana → Ākarana (Auckland)                                                                         
  37. Otautahi → Ōtautahi (Christchurch)                                                                   
  38. Otepoti → Ōtepoti (Dunedin)                                                                          
  39. Poneke → Pōneke (Wellington)                                                                         
  40. Tahuna → Tāhuna (shallow sandy area/beach)                                                           
                                                                                                           
  Actions & Verbs                                                                                          
                                                                                                           
  41. Korero → Kōrero (speak/talk/story)                                                                   
  42. hikoi → hīkoi (walk/march)                                                                           
  43. Kaikorero → Kaikōrero (speaker)                                                                      
  44. Kokiri → Kōkiri (rush/charge)                                                                        
  45. Whakata → Whakatā (rest/pause)                                                                       
  46. Whakama → Whakamā (shy/embarrassed)                                                                  
  47. Arahi → Ārahi (lead/guide)                                                                           
  48. Whakatopu → Whakatōpū (gather/collect)                                                               
                                                                                                           
  Nature & Environment                                                                                     
                                                                                                           
  49. Koraki → Kōraki (north wind)                                                                         
  50. atanga → ātanga (form/appearance)                                                                    
  51. Moemoea → Moemoeā (dream)                                                                            
  52. Puawai → Puāwai (flower/bloom)                                                                       
  53. Whetu → Whetū (star)                                                                                 
  54. Kopere → Kōpere (plover bird)                                                                        
  55. ti kouka → tī kōuka (cabbage tree)                                                                   
  56. Katote (in Ponga, Kaponga, Katote) → kātote (tree fern species)                                      
  57. pikao/pingao → pīngao (golden sand sedge)                                                            
  59. Rakau Kirihimete → Rākau Kirihimete (Christmas tree)                                                 
                                                                                                           
  Qualities & Emotions                                                                                     
                                                                                                           
  60. Tumanako → Tūmanako (hope)                                                                           
  61. Rangimarie → Rangimārie (peace)                                                                      
  62. Mahaki → Māhaki (humble/meek)                                                                        
  63. Ukaipo → Ūkaipō (mother/home/source of sustenance)                                                   
  64. Ngakau → Ngākau (heart/emotion)                                                                      
  65. Ataahua → Ātaahua (beautiful)                                                                        
                                                                                                           
  Body Parts                                                                                               
                                                                                                           
  66. Kopu → Kōpū (belly/stomach)                                                                          
                                                                                                           
  Food                                                                                                     
                                                                                                           
  67. Aihikirimi → Aihikirīmi (ice cream)                                                                  
                                                                                                           
  Other                                                                                                    
                                                                                                           
  68. Haparangi → Hāparangi (silly/crazy)                                                                  
  69. heki → hēki (egg)  

